111111111111111111111111
10000000000C000000000001
10000111110000000C000001
100000000000000011000001
10000C000001111111000001
1000000C0001000000000C01
1P0011E00001000C00000001
111111111111111111111111
